NO ./srcs/config/textures/book.xpm
SO ./srcs/config/textures/book.xpm
WE ./srcs/config/textures/book.xpm
EA ./srcs/config/textures/book.xpm
F 22,100,0

C 225,30,0


11111111111111111
10001111100000001       111 111
10000000000000001      100010001
10000100100100001      100010001
10000000000000001       1000001
10000000000000001        10001
11000111000000001         101
100001 1000000001111111111101
10011  1000000000000000000001
1001   1111111111111111111111
1001
1001
1001
1001
1001
1001
1001
1001
100111111111111111111111111111111111111111111111111111111111111111111111111111111111111111111111111111111111111111111111111111
100000000001000000000000000000000000000000000000000000000000000000000000000000000000000000000000000000000000000000000000000001
100000000001000000000000000000000000000000000000000000000000000000000000000000000000000000000000000000000000000000000000000001
100000000000000000000000000000000000000000000000000000000000000000000000000000000000000000000000000000000000000000000000000001
100000000000100000000000000000000100000000000000000000000000000000000000000000000000000000000000000000000000000000000000000001
100000000000000000000000000000000000000000000001000000S0000000000000000000000000000000000000111100000000000000000000000000001
100000000000000000000000000000000000010000000000000000000000000000000000000000000000000000000000000000000000000000000000000001
100000000000000000000000000000000000000000000000000000000000000000000000000000000000000000000000000000000000000000000000000001
100000000001000000000000000000000000000000000001000000000000000000000000000000000000000000000000000000000000000000000000000001
100000000000000000000000010000000000000000000000000000000000000000000000000000000000000000000000000000000000000000000000000001
100000000000100000000000000000000000000000000000000000000000000000000000000010000000000000000000000000000000000000000000011111
100000000000000000000000000000000000000000000000000000000000000000000000000000000000000000000000000000000000000000000000000001
100000000000000000000000000000000000000000000000000000000000000000000000000000000000000000000000000000000000000000000000000001
100000000000000000000001000000000000000000000000001100000000000000000000000000000000000000000001111000000000000000000000000001
100000000000000000000000000000010000000000000000000000000000000011000000000000000000000000000000000000000000000000000000000001
100000000000000000000000000000000000000000000000000000000000000010000000000000000000000000000000000000000000000000000000000001
100000000000000000000000000000000000000000000000100000000000000010000000000000000000000000000000000000000000000000000000000001
100000000000000000000000000000000000000000000000000000000000000110000000000000000100000000000000000000000000000000000000000001
100000000000000000011000000000000000000000100000000000000000000000000000000000000000000000000000000000000000000000000000000001
100000000000000000010000000000000000000000000000000000000000000000000000000000000100000000000000000000000000000000000000000001
100000000000000000010000000001000000000000000000000000000000000000000000000000000100000000000000000000000011100000000000000001
100000000000000000110000000000000000000000000000000000000000001100000000000000000100000000000000000000000010000000000000000001
100000000000000000000000000000000000000011000000100000000000001000000000000000000100000000000000000000000011000000000000000001
100000000000000000000000011000000000000010000000000000000000001000000000000000000000000000000000000000011111011100000000000001
100000000000000000000000010000000000000010000000000000000000011000000000000000000000000000000000000000111000010000000000000001
100000000000000000000000010000000000000110000000000000000000000000000000000000000000000000000000000001000000110000001000000001
100000000000000000000000110000000000000000000000000000000000000000000000000000000000000000000000000000110000001000000000000001
100000000000000000000000000000000000000000000000000000000000000000000000000010000000000000000000000000010000000000000000000001
100000000000000000000000000000000000000000000000000000000000000000000000000000000000000000000000000000000000000000000000000001
100000000000000000000000000000000000000000000000000000000000000000000000000000000000000000000000000000000000000000000000000001
100000000000000001100000000000000000000011000000001000000000000000000000000000000000000000000000000000000000000000000000000001
100000000000000001000000000000000000000010000000000000000000000000000010000000000000000000000000000000000000000000000000000001
100000000000000001000000000000000000000010000000000000000000000000000000000000000000000000000000000000000000000000000000000001
100000000000000011000000000000000000000110000000000000000100000000000010000000000000000000000000000000000000000000000000000001
100000000000000000000000000000000000000000000000000000000000000000000000000000000000000000000000000000000000000000000000000001
100000000000000000000000000000000000000000000000000000000000000000000000000000000000000000000000000000000000000000000000000001
100000000000000000000000000000000010000000000000000000000000000100000000000000000000000000000000000000000000000000000000000001
100000000000000000000000000000000000000000000000000000000000000000000000000000000000000000000000000000000000000000000000000001
100000000000000000000000000000000000000000000000000000000000000000000000000000010000000000000000000000000000000000000000000001
100000000000000000000000000000000000000000000000000000000000000000000010000000000000000000000000000000000000000000000000000001
100000000000000000000000000000000000000000000000000000000000000000000000000000000000000000000000000000000000000000000000000001
100000000001000000000000000000000000000000000000000000000000000100000000000000000000000000000000000000000000000000000000000001
100000000000000000000000000000000000000000000000000000000000000000000000000000000000000000000000000000000001000000000000000001
100000000000000000000000000000000000000000000000000000000000000000000000000000000010000000000000000000000000000000000000000001
100000000000000000000000000000000000000000000000000000000000000000000000000000000000000000000000000000000000000000000000000001
100000000000100000000000000000000000000000000000001000000000000000000000000000000000000000000000000000001110001000000000000001
100000000000000000000000000000000000000000000000000000000000000000000000000000000000010000000000000000010000000000000000000001
100000000000000000000000010000000000000000000000000000000000000000000000000000000000000000000000000000000000000000100000000001
100000000000000000000000000000000000000000000000000000000000000000000000000100000000000000000000000000000000000000000000000001
100000000000000000000000000000000000000000000000000000000000000000000000000000000000000000000000000000000000000000000000000001
111111111111111111111111111111111111111111111111111111111111111111111111111111111111111111111111111111111111111111111111111111
